.+---+---+.+---+---+
.|...|...|.|...|...|
.|.|.|.|.|.|.|.|.|.|
.|.|.|.|.|.|.|.|.|.|
.|.|.|.|.|.|.|.|.|.|
.|.|.|.|.|.|.|.|.|.|
.|.|.|.|.|.|.|.|.|.|
.|.|.|.|.|.|.|.|.|.|
...|...|.....|...|.|
---+---+-----+---+..